##############################################
#              #                             #
#  ##########  #############  #######  ####  #
#           #                 #        #     #
#  #######  #############  ###################
#  #     #  #           #  #                 #
#  #  #  #  #  #  ####  #  #  #############  #
#  #  #  #  #  #  #     #  #  #  #        #  #
#  #  ####  #  ##########  #  #  ####  #  #  #
#  #     #  #              #           #  #  #
#  ####  #  ################  #############  #
#     #  #                    #              #
####  #  ######################  ##########  #
#  #  #                    #     #     #  #  #
#  #  ####  #############  #  ####  #  #  #  #
#  #  #     #     #     #  #  #     #     #  #
#  #  #  #######  ####  #  #  #  ##########  #
#     #  #              #  #  #              #
####  #  #  ##########  #  #  #  #############
#  #  #  #  #  #     #  #  #  #  #           #
#  #  #  #  #  ####  #  #  #  #  #  #######  #
#  #  #  #  #        #  #  #  #  #  #     #  #
#  #  #  #  #  #######  #  #  #  #  #  #  #  #
#  #  #  #  #           #  #  #  #  #  #  #  #
#  #  #  #  #############  #  #  #  ####  #  #
#     #  #                 #  #  #        #  #
#  ####  #  ################  #  #######  #  #
#  #     #  #        #        #     #     #  #
#  ####  #  #######  #  ##########  #######  #
#        #           #  #                    #
##############################################
