##############################################
#                    #        #     #     #  #
#  ####  #############  ####  #  #  #  #  #  #
#     #     #              #     #     #  #  #
####  ####  #  ##########  ##########  #  #  #
#     #     #     #     #           #  #  #  #
#######  ####  ####  #  #######  #  #  #  #  #
#        #     #     #           #  #  #     #
#  #######  ####  #  ####  #######  #  #######
#           #     #     #  #     #  #  #     #
#############  #######  ####  ####  #  #  #  #
#           #  #     #     #     #  #     #  #
#  #  #  ####  #  #  ####  ####  #  #######  #
#  #  #     #  #  #     #        #     #  #  #
#  #  ####  #  #  ####  #############  #  #  #
#  #     #           #  #           #  #     #
#######  ##########  ####  #######  #  #######
#     #  #     #           #     #  #  #     #
#  #  ####  #  #  ##########  #  #  #  #  #  #
#  #  #     #  #           #  #  #  #     #  #
#  #  #  #######  #######  #  #  ##########  #
#  #  #  #     #     #     #  #        #     #
#  #  #  #  #  ####  #  #######  ####  #  ####
#  #     #  #  #     #        #     #  #     #
#  #######  #  #############  #  #  #######  #
#        #  #     #     #     #  #  #     #  #
#  ####  #  ####  #  #  #  #######  #  #  #  #
#  #     #  #     #  #     #     #  #  #  #  #
#  #  ####  #  ####  #######  #  #  #  ####  #
#  #     #  #  #              #     #     #  #
#  #  ####  ####  #############  ####  #  #  #
#  #     #        #           #     #  #     #
#  ####  ##########  #######  ####  ##########
#  #     #           #        #  #           #
#  #  #############  #  #######  #  #######  #
#  #     #     #     #  #     #     #     #  #
#  ####  #  #  #  ####  #  ####  ####  #  ####
#  #     #  #  #     #     #     #     #     #
#  #######  #  #  #  #######  ####  #######  #
#  #        #  #  #  #     #  #        #     #
#  #  #  ####  #  #  #  #  #  #######  #  ####
#     #     #  #  #  #  #  #           #  #  #
#  #######  #  #  #  #  ####  ##########  #  #
#     #     #     #  #  #     #        #  #  #
#######  #######  ####  #  #  #  ####  #  #  #
#        #     #  #     #  #  #     #  #  #  #
#  #######  ####  #  ####  #  #  #  ####  #  #
#        #     #  #        #  #  #     #  #  #
#######  #  #  #  #############  #  #  #  #  #
#     #  #  #  #     #     #     #  #  #     #
#  #  #  ####  #  ####  #  #  #  ####  #  ####
#  #           #        #     #  #           #
##############################################
