###################
#     #        #  #
#  ####  #  #  #  #
#  #     #  #     #
#  #  #  ##########
#  #  #           #
#  #  ##########  #
#  #        #  #  #
#  #######  #  #  #
#     #     #  #  #
####  #  ####  #  #
#        #        #
###################
